10012
0000000100
0000000000
0010010000
0101000000
1100000000
0000000000
0000100000
0000000001
0000001010
0000000100
